1111111111111
1C010000PCXC1
1000C11111001
100011E00X001
1111111111111