1111111111
1P011E00C1
1111111111