1111111111
1E0P000011
1111111111