11111111111111111111
1P100000001111111111
1010C000100X00001111
10100010101111000111
10111110101111000111
101000101011110C0111
10001000101111000111
11011111100000000111
10000000101111101111
10111110101111101111
10111110100000001111
101111101000C0001111
101111101000X0001111
10000000100000001111
10111110001111111111
10111111111111111111
10111111111111111111
10111111111111111111
10110000000000111111
100001111111100000E1
11111111111111111111