1111111111
100C000X11
1P11111111
1E11111111
1C11000011
1111111111